*__.__________
._______*_____
.___*_________
_______.__*___
__*_.____*__*_
