______.___*__*_*_*_____*_____*____*______*______*___*___*_
__*_*____*___*___*____*___*___*___*__*__.___*__*___*______
____.___*______*___*_____*____*_____*____*____*_____*__*__
**_____*__*_____***___*___****___*__*___**___*___.__*__*__
__*____.____**___*__*____*___*___*_____*_____*__*__*_**___
__*__*___*_____*____*_____*__*___*___*___*_*____._*___*_*_
