__.___.____._
*__*.___.____
__*___*___*__
__*__*__.____
___.___*___._
