___.______.____*______*.__*__
___.___________________***___
___.____*____.___.___*___.___
__*___._____*__.___*___._____
______.__*_______.____*______
__**____****__._____*__._____
_.___***_________***_________
__._________.__*_*__.____.___
_____*__.__________***_______
____________***________**____
