__.______________
____*.___________
__*____*.________
__________*._____
____*________*.__
__*_____*._____*_
____*.________*__
